halo	hello
nasep	work
hoih	good
kei	I
nang	you
hong paita	is coming
inn	house
tui	water
an	food
aw	yes
hilo	no
ka min pen	my name is
na dam hiam	how are you
ki muh theih lungdam	nice to see you
lungdam mahmah	thank you very much
na pai nuam in	safe journey
kei lungdam	I am happy
dailenbuk koi ah om ahia	where is the toilet
hehpihna tawh	please
hongmai sak in	excuse me
tuni	today
zingciang	tomorrow
nitak	evening
zingsang	morning
giat	eight
sawm	ten