en	zo
hello	hello
work	nasep
good	hoih
house	inn
water	tui
food	an
yes	aw
no	hilo
love	itna
affection	ngaihna
story	tangthu
word	laimal
name	min
what	bang
old	lui
new	thak
age	kum
year	kum
please	hehpihna tawh
grace	hehpihna
help	huh
fine	pha
test	sinna
today	tuni
tomorrow	zingciang
evening	nitak
morning	zingsang